AAAAAAAAAA
AAAAAAAAAA
AAAAAAAAAA
AAAAAAAAAA
AAAAAAAAAA
AAAAAAAAAA
AAAAAAAAAA
AAAAAAAAAA
ABBBBBBBBA
ABBBBBBBBA
ABBBBBBBBA
ABBBBBBBBA
ABBBBBBBBA
ABBBBBBBBA
ABBBBBBBBA
ABBBBBBBBA
ABBBBBBBBA
ABBBBBBBBA
ABBBBBBBBA
ABBBBBBBBA
ABBBBBBBBA
ABBBBBBBBA
ABBBBBBBBA
ABBBBBBBBA
ABBBBBBBBA
ABBBBBBBBA
ABBBBBBBBA
ABBBBBBBBA
ABBBBBBBBA
ABBBBBBBBA
ABBBBBBBBA
ABBBBBBBBA
ABBBBBBBBA
ABBBBBBBBA
ABBBBBBBBA
ABBBBBBBBA
ABBBBBBBBA
ABBBBBBBBA
ABBBBBBBBA
ABBBBBBBBA
ABBBBBBBBA
ABBABBBBCA
ABBBBAAAAA
AAABBGBBBA
ABBBBGBBBA
ABBAABBBBA
ABBBBBBAAA
ABBBBBBBBA
ABBBBAABBA
AAABBBBBBA
ABBBBBBBBA
AAAAAAABBA
ABBBBBBBBA
ABBBBBAAAA
ABBBBBBBBA
ABBBAABBBA
ABBABBABBA
ABAABBBAAA
ABBBBBBBBA
AAAABBAABA
ABBABBBBBA
AAAABBAAAA
ABBBBBBBBA
ABBAAAABBA
ABBBBBBBBA
AAAAAAAAAA
AAAAAAAAAA
AAAAAAAAAA
AAAAAAAAAA
AAAAAAAAAA
AAAAAAAAAA
AAAAAAAAAA
AAAAAAAAAA
80
75
955
-1
