AAAAAAAAAA
AAAAAAAAAA
AAAAAAAAAA
AAAAAAAAAA
AAAAAAAAAA
AAAAAAAAAA
AAAAAAAAAA
AAAAAAAAAA
ABBBBBBBBA
ABBBBBBBBA
ABBBBBBBBA
ABBBBBBBBA
ABBBBBBBBA
ABBBBBBBBA
ABBBBBBBBA
ABBBBBBBBA
ABBBBBBBBA
ABBBBBBBBA
ABBBBBBBBA
ABBBBBBBBA
ABBBBBBBBA
ABBBBBBBBA
ABBBBBBBBA
ABBBBBBBBA
ABBBBBBBBA
ABBBAAANBA
ABBBAJAPBA
ABBBAAABBA
ABBBBBBBBA
ABRBBAAAGA
ABBBBBBBGA
AGGGGGGGGA
ABBGBBBBGA
ABBGWBBBGA
ABBGABBBBA
ABBBBBBBBA
ABGGGGBBBA
ABBBBGBBBA
ABBBBBBBBA
ABBBBBAABA
ABBAABBBBA
ABBBBBBBBA
AAAAAABBBA
AAAAAABBBA
APAAAABBBA
ABAAAABBBA
ABVVVVBBBA
AAAAAAAAAA
AAAAAAAAAA
AABBBBAAAA
AABBBBAAAA
AABBBBBBBA
AAAAAAAABA
ABABBBBBBA
AABBABBBBA
AABABABBBA
AABBBBAAAA
ABAAABBBBA
ABBBABBBBA
ABBBABAABA
ABBBABBBBA
ABAAABBBBA
ABABBBBBBA
ABATABBBBA
ABAAAWWWWA
AAAAAAAAAA
AAAAAAAAAA
AAAAAAAAAA
AAAAAAAAAA
AAAAAAAAAA
AAAAAAAAAA
AAAAAAAAAA
AAAAAAAAAA
121
68
675
-1

N 8,26 5,28 6,28 7,28 
P 8,27 4,30 5,30 4,31 4,32 4,33 4,34 4,35 4,36 4,37 4,38 4,39 4,40 4,41 4,42 4,43 4,44 4,45 4,46 4,47 4,48 4,49 4,50 
P 2,45 2,42 2,43 2,44 2,45 2,46 2,47 
