AAAAAAAAAA
AAAAAAAAAA
AAAAAAAAAA
AAAAAAAAAA
AAAAAAAAAA
AAAAAAAAAA
AAAAAAAAAA
AAAAAAAAAA
ABBBBBBBCA
ABBBBBBBAA
ABBBBBGBBA
ABBBBBGAAA
ABBBBBGBBA
ABAAAAAAAA
ABBBBBBBBA
AAABBBBBBA
ABBABBBBBA
ABBBABBBBA
ABBBBAABBA
ABABBBBBAA
ABBABBBBBA
AABAAAAAAA
ABBBBBBBBA
ABAABBBBBA
ABBBBBBBBA
AAAAABBBBA
ABBBBABBBA
ABBBBBBBAA
ABBBBBABBA
ABBBBBBBBA
ABBBBBBBAA
ABBBBABBBA
ABBBBBBABA
ABBGBBBBBA
ABBGAAAAAA
ABBGBBBBBA
ABBGBBBBBA
ABBGBBBGBA
ABBGBBAGBA
ABBBBBBGBA
ABBBBBBGBA
ABBBBBBGBA
ABBBBBBGBA
ABBAAAAAAA
ABBBBBBBBA
AAABBBBBBA
AAAAAABBBA
ABGAAABBBA
ABGBBBABBA
ABGBBBBBAA
AAGBBBBBAA
AAGBBBAAAA
AAAAAAAAAA
AAAAAAAAAA
AAAAAAAAAA
ABBBBBBBBA
ABBBBBBBBA
ABBBBBBBBA
ABBBBBBBBA
ABBBBBBBBA
ABBBBBBBBA
ABBBBBBBBA
ABBBBBBBBA
ABBBBBBBBA
ABBBBBBBBA
AAAAAAAAAA
AAAAAAAAAA
AAAAAAAAAA
AAAAAAAAAA
AAAAAAAAAA
AAAAAAAAAA
AAAAAAAAAA
AAAAAAAAAA
40
76
735
-1
