AAAAAAAAAA
AAAAAAAAAA
AAAAAAAAAA
AAAAAAAAAA
AAAAAAAAAA
AAAAAAAAAA
AAAAAAAAAA
AAAAAAAAAA
ABBBBBBBBA
ABBBBBBBBA
ABBBBBBBBA
ABBBBBBBBA
ABBBBBBBBA
ABBBBBBBBA
ABBBBBBBBA
ABBBBBBBBA
ABBBBBBBBA
ABBBBBBBBA
ABBBBBBBBA
ABBBBBBBBA
ABBBBBBBBA
ABBBBBBBBA
ABBBBBBBBA
ABBBBBBBBA
ABBBBBBBBA
AAAAAAAAAA
AAAAAAAAAA
AAAAAAAAAA
AAAAAAAAAA
AAAAAAAAAA
AAAAAAAAAA
AAAAAAAAAA
AAAAAAAAAA
ABBBBBBBBA
ABBBBBGBCA
ABBBBBGAAA
ABBBBBGBBA
AAABAAAAAA
ABBBBBBBBA
ABBABBBBBA
ABBBABBBBA
ABBBBABBBA
ABBBBBBBAA
ABBBBBBBAA
ABBBBBBABA
ABBBBBABBA
ABBBBABBBA
ABBBABBBBA
AGBABBBBBA
AGAAAAAAAA
AGBBBBBBBA
AGBBBBBBBA
AGBBBBBBBA
AAAAAAABBA
ABBBBBBABA
ABBBBBBBBA
ABBAAAAAAA
AABBBBBBBA
AABBBBBBBA
ABAABBBBBA
ABBBAABBBA
ABBBBBBBAA
ABBBBBBAAA
ABBBBAABBA
ABBAABBBBA
AAAAAAAAAA
AAAAAAAAAA
AAAAAAAAAA
AAAAAAAAAA
AAAAAAAAAA
AAAAAAAAAA
AAAAAAAAAA
AAAAAAAAAA
37
51
975
-1
 