AAAAAAAAAA
AAAAAAAAAA
AAAAAAAAAA
AAAAAAAAAA
AAAAAAAAAA
AAAAAAAAAA
AAAAAAAAAA
AAAAAAAAAA
ABBBBBBBBA
ABBBBBBBBA
ABBBBBBBBA
ABBBBBBBBA
ABBBBBBBBA
ABBBBBBBBA
ABBBBBBBBA
ABBBBBBBBA
ABBBBBBBBA
ABBBBBBBBA
ABBBBBBBBA
ABBBBBBBBA
ABBBBBBBBA
ABBBBBBBBA
ABBBBBBBBA
ABBBBBBBBA
ABBBBBBBBA
ABBBBBBBBA
ABBBBBBBBA
ABBBBBBBBA
ABBBBBBBBA
ABBBBBBBBA
ABBBBBBBBA
ABBBBBBBBA
ABBBBBBBBA
ABBBBBBBBA
ABBBBBBBBA
ABBBBBBBBA
ABBLBBBBBA
ABBGBBBBCA
ABBGBBBBBA
ABBGBBBBBA
ABBGBBBBBA
ABBBBBUBBA
ABBBBBBBBA
ABBBGUGBBA
ABBBGGGBBA
ABBBGGGBBA
ABBBGGGGGA
ABBBBBBBGA
ABBBBBBBGA
ABBBBBBBGA
ABBBBBBBGA
AGGGGGGGGA
AGBBBBBBBA
AGBBBBBBBA
ABBBBBBBBA
AABBBBBBBA
AAABBBBBBA
AAAABBBBGA
AAAAABBBGA
AAAAAABBGA
AAAAAAABGA
AAAAAAAAGA
ANBXXXXBGA
ABBBBBBBGA
ABBWWWWBGA
AAAAAAAAAA
AAAAAAAAAA
AAAAAAAAAA
AAAAAAAAAA
AAAAAAAAAA
AAAAAAAAAA
AAAAAAAAAA
AAAAAAAAAA
24
45
985
-1

L 4,37 5,39 6,39 7,39 8,39 9,39 
N 2,63 4,65 5,65 6,65 7,65 
