AAAAAAAAAA
AAAAAAAAAA
AAAAAAAAAA
AAAAAAAAAA
AAAAAAAAAA
AAAAAAAAAA
AAAAAAAAAA
AAAAAAAAAA
ABBBBBBBBA
ABBBBBBBBA
ABBBBBBBBA
ABBBBBBBBA
ABBBBBBBBA
ABBBBBBBBA
ABBBBBBBBA
ABBBBBBBBA
ABBBBBBBBA
ABBBBBBBBA
ABBBBBBBBA
ABBBBBBBBA
ABBBBBBBBA
ABBBBBBBBA
ABBBBBBBBA
ABBBBBBBBA
ABBBBBBBBA
ABBBBBBBBA
ABBBBBBBBA
ABBBBBBBBA
ABBBBBBBBA
ABBBBBBBBA
ABBBBBBBBA
ABBBBBBBBA
ABBBBBBBBA
ABBBBBBBBA
ABBBBBBBBA
ABBBBBBBBA
ABBBBBBBBA
ABBBBBBBBA
ABBBBBBBBA
ABBBBBBBBA
ABAAABBBBA
ABACABBBBA
ABAVABBBBA
ABBBBBAAGA
ABBABBAAGA
ABBBBBAAGA
ABBAAVAAGA
ABBBBBAAGA
ABBBAAAAGA
ABABBBAAGA
ABABBBVBGA
ABBABBAAGA
ABBAAAAAGA
ABBBBBVVGA
ABBBBBVVGA
ABBBBBBVGA
ABBABBAAGA
ABABBBAAGA
ABBBBBAAGA
AAAABBAAGA
ABBBBBAAGA
ABBBBAAAGA
ABBBBBAAGA
ABBABBAAGA
ABAABBAAGA
AAAAAAAAAA
AAAAAAAAAA
AAAAAAAAAA
AAAAAAAAAA
AAAAAAAAAA
AAAAAAAAAA
AAAAAAAAAA
AAAAAAAAAA
24
45
985
-1
 