AAAAAAAAAA
AAAAAAAAAA
AAAAAAAAAA
AAAAAAAAAA
AAAAAAAAAA
AAAAAAAAAA
AAAAAAAAAA
AAAAAAAAAA
ABABBBBBBA
ABABBBBBBA
ABABBBBBBA
ABBBBBBBBA
AAAAAABAAA
ABBBBBBBBA
ABBBBBBBBA
ABBBBBBBBA
ABBBBABABA
ABBBBBWBBA
AAABBBABBA
ABBBBBBBBA
ABBBWWWWWA
ABBBAAAAAA
ABBABBBBBA
ABBBBBBBBA
ABBBBBBBBA
AAAABBVVGA
ABBBBBBBGA
ABBBBBBBGA
ABBBBBBBGA
ABBBABWWWA
ABBBBBBBBA
AABBBBBBBA
ABABBBBBBA
ABBABBBBBA
ABBBABBBBA
ABBBBVBBBA
ABBBBBAAAA
ABBBBBBBBA
AAAABBBBCA
ABBBAAAVAA
ABBBBBBBBA
AWWWWWWWWA
ABBBBBBBBA
ABBBBBBBBA
ABBBBBBBBA
ABBBBBBBBA
AAAAAAAAAA
AAAAAAAAAA
AAAAAAAAAA
AAAAAAAAAA
AAAAAAAAAA
AAAAAAAAAA
AAAAAAAAAA
AAAAAAAAAA
ABBBBBBBBA
ABBBBBBBBA
ABBBBBBBBA
ABBBBBBBBA
ABBBBBBBBA
ABBBBBBBBA
ABBBBBBBBA
ABBBBBBBBA
ABBBBBBBBA
ABBBBBBBBA
ABBBBBBBBA
AAAAAAAAAA
AAAAAAAAAA
AAAAAAAAAA
AAAAAAAAAA
AAAAAAAAAA
AAAAAAAAAA
AAAAAAAAAA
AAAAAAAAAA
23
19
115
1
 