AAAAAAAAAA
AAAAAAAAAA
AAAAAAAAAA
AAAAAAAAAA
AAAAAAAAAA
AAAAAAAAAA
AAAAAAAAAA
AAAAAAAAAA
ABBBBBBBBA
ABBBBBBBBA
ABBBBBBBBA
ABBBBBBBBA
ABBBBBBBBA
ABBBBBBBBA
ABBBBBBBBA
ABBBBBBBBA
ABBBBBBBBA
ABBBBBBBBA
ABBBBBBBBA
ABBBBBBBBA
ABBBBBBBBA
ABBBBBBBBA
ABBBBBBBBA
ABBBBBBBBA
ABBBBBBBBA
ABBBBBBBBA
ABBBBBBBBA
ABBBBBBBBA
ABBBBBBBBA
ABBBBBBBBA
ABBBBBBBBA
ABBBBBBBBA
ABBBBBBBBA
ABBBBBBBBA
ABBBBBBBBA
ABBBBBBBBA
ABBBBBBBBA
ABBBBBBBBA
ABBBBBBBBA
ABBBBCBBBA
ABBBAAABBA
ABBBBBBBBA
AAAABABBAA
ABBBBAAEAA
ABAAAABBAA
ABBBGAEAAA
AAAAGBBBBA
ABBBGAAAAA
ABBBGBBBBA
ABBBBGBBBA
ABBBBGBBBA
ABBBGBBBBA
ABBBGBBBBA
ABBBBBBBBA
AAAABBBBBA
ABBBABBBBA
ABBBBABBBA
ABBBBBBBBA
ABBBBBBBAA
ABBBBBBABA
ABBBBAABBA
ABBBBBBBBA
AAAABBBHBA
ABBBBBBBBA
ABBBABBBBA
AAAAAAAAAA
AAAAAAAAAA
AAAAAAAAAA
AAAAAAAAAA
AAAAAAAAAA
AAAAAAAAAA
AAAAAAAAAA
AAAAAAAAAA
39
58
795
1
