AAAAAAAAAA
AAAAAAAAAA
AAAAAAAAAA
AAAAAAAAAA
AAAAAAAAAA
AAAAAAAAAA
AAAAAAAAAA
AAAAAAAAAA
ABBABBABBA
ABBABBABBA
ABBABBABBA
ABAABBAABA
ABBBBBBBBA
ABBBBBBBBA
AAAAAAAABA
ABBBBBBBBA
ABAAAAAAAA
ABBBBBBBBA
ABBBBABBBA
AAAABABABA
ABBBAABABA
ABABBBABBA
ABBAABBBAA
AABBBAAABA
ABAABBBBBA
ABBBAAAABA
ABBBABBBBA
ABAAABAAAA
ABAGBBBBBA
ABAGAAAABA
ABAGABBABA
ABAGABBABA
ABAGABBABA
ABAGABBABA
ABAGABBABA
ABAAABBABA
ABBABBBBBA
ABBABAAAAA
ABBBBBBBBA
ABBBBBBBBA
ABBBBBBBBA
ABBBBBBBBA
ABBBABBBBA
ABBBBBBACA
ABBBBBBAAA
ABBBBBBBBA
AAAAAAAAAA
ABBBBBBBBA
ABBBBBBBBA
ABBBBBBBBA
ABBBBBBBBA
ABBBBBBBBA
ABBBBBBBBA
ABBBBBBBBA
ABBBBBBBBA
ABBBBBBBBA
ABBBBBBBBA
ABBBBBBBBA
ABBBBBBBBA
ABBBBBBBBA
ABBBBBBBBA
ABBBBBBBBA
ABBBBBBBBA
ABBBBBBBBA
ABBBBBBBBA
AAAAAAAAAA
AAAAAAAAAA
AAAAAAAAAA
AAAAAAAAAA
AAAAAAAAAA
AAAAAAAAAA
AAAAAAAAAA
AAAAAAAAAA
78
13
120
1
